SenShelbyPress	Senator Richard Shelby
SenatorSessions	Senator Jeff Sessions 
repjobonner	Representative Jo Bonner 
RepMarthaRoby	Representative Martha Roby 
RepMikeRogersAL	Representative Mike Rogers 
robert_aderholt	Representative Robert B. Aderholt
RepMoBrooks	Representative Mo Brooks
bachusal06	Representative Spencer Bachus 
lisamurkowski	Senator Lisa Murkowski &nbsp;
SenatorBegich	Senator Mark Begich
repdonyoung	Representative Don Young
SenJohnMcCain	Senator John McCain
senjonkyl	Senator Jon Kyl 
repgosar	Representative Paul A. Gosar
RepTrentFranks	Representative Trent Franks 
benquayle	Representative Ben Quayle 
RepDavid	Representative David Schweikert 
JeffFlake	Representative Jeff Flake 
RepRaulGrijalva	Representative Raul M. Grijalva 
Rep_Giffords	Representative Gabrielle Giffords 
JohnBoozman	Senator John Boozman 
reprickcrawford	Representative Rick Crawford 
RepTimGriffin	Representative Tim Griffin 
rep_stevewomack	Representative Steve Womack 
repmikeross	Representative Mike Ross
SenatorBoxer	Senator Barbara Boxer 
RepMcClintock	Representative Tom McClintock 
dorismatsui	Representative Doris Matsui 
RepLynnWoolsey	Representative Lynn Woolsey 
askgeorge	Representative George Miller 
NancyPelosi	Representative Nancy Pelosi
RepGaramendi	Representative John Garamendi 
RepSpeier	Representative Jackie Speier
RepAnnaEshoo	Representative Anna G. Eshoo 
RepMikeHonda	Representative Mike Honda 
repsamfarr	Representative Sam Farr
RepCardoza	Representative Dennis Cardoza 
RepJeffDenham	Representative Jeff Denham 
GOPWhip	Representative Kevin McCarthy 
eltongallegly24	Representative Elton Gallegly 
BuckMcKeon	Representative Howard P. (Buck) McKeon 
bradsherman	Representative Brad Sherman 
RepAdamSchiff	Representative Adam Schiff 
repbecerra	Representative Xavier Becerra 
RepKarenBass	Representative Karen Bass
replrichardson	Representative Maxine Waters
replrichardson	Representative Laura Richardson 
gracenapolitano	Representative Grace Napolitano
RepEdRoyce	Representative Ed Royce 
RepJerryLewis	Representative Jerry Lewis 
repgarymiller	Representative Gary Miller 
BacaCA43	Representative Joe Baca 
kencalvert	Representative Ken Calvert 
MaryBonoMack	Representative Mary Bono Mack 
DanaRohrabacher	Representative Dana Rohrabacher
RepJohnCampbell	Representative John Campbell
DarrellIssa	Representative Darrell Issa
BilbrayCA50	Representative Brian P. Bilbray 
CongBobFilner	Representative Bob Filner 
MarkUdall	Senator Mark Udall
SenBennetCO	Senator Michael Bennet
RepDianaDeGette	Representative Diana DeGette
jaredpolis	Representative Jared Polis
reptipton	Representative Scott R. Tipton
repcorygardner	Representative Cory Gardner 
repmikecoffman	Representative Mike Coffman
RepPerlmutter	Representative Ed Perlmutter
joelieberman	Senator Joe Lieberman 
SenBlumenthal	Senator Richard Blumenthal 
RepJohnLarson	Representative John Larson
rosadelauro	Representative Rosa L. DeLauro
jahimes	Representative Jim Himes 
chrismurphyct	Representative Chris Murphy 
senatorcarper	Senator Tom Carper 
chriscoons	Senator Christopher Coons
johncarneyde	Representative John Carney
eleanornorton	Delegate Eleanor Holmes Norton
SenBillNelson	Senator Bill Nelson
SenRubioPress	Senator Marco Rubio
congjeffmiller	Representative Jeff Miller
Rep_Southerland	Representative Steve Southerland
RepCorrineBrown	Representative Corrine Brown
repsandyadams	Representative Sandy Adams
andercrenshaw	Representative Ander Crenshaw
RepRichNugent	Representative Richard Nugent
repcliffstearns	Representative Cliff Stearns
RepWebster	Representative Daniel Webster
RepGusBilirakis	Representative Gus M. Bilirakis 
RepDennisRoss	Representative Dennis Ross 
VernBuchanan	Representative Vern Buchanan
ConnieMackIV	Representative Connie Mack 
congbillposey	Representative Bill Posey 
TomRooney	Representative Thomas J. Rooney 
RosLehtinen	Representative Ileana Ros-Lehtinen 
repteddeutch	Representative Ted Deutch 
mariodb	Representative Mario Diaz-Balart 
AllenWest	Representative Allen West 
RepRivera	Representative David Rivera 
saxby08	Senator Saxby Chambliss 
SenatorIsakson	Senator Johnny Isakson 
JackKingston	Representative Jack Kingston 
sanfordbishop	Representative Sanford D. Bishop, Jr. 
RepWestmoreland	Representative Lynn Westmoreland 
RepHankJohnson	Representative Hank Johnson 
RepTomPrice	Representative Tom Price 
AustinScottGA08	Representative Austin Scott 
reptomgraves	Representative Tom Grav
RepPaulBrounMD	Representative Paul C. Broun 
RepPhilGingrey	Representative Phil Gingrey 
repjohnbarrow	Representative John Barrow
RepDavidScott	Representative David Scott 
Daniel_Inouye	Senator Dan Inouye 
danakaka	Senator Daniel Kahikina Akaka 
@rephanabusa	Representative Colleen Hanabusa
maziehirono	Representative Mazie Hirono 
labrador4idaho	Representative Raul Labrador
mikesimpson4id	Representative Mike Simpson
SenatorDurbin	Senator Dick Durbin 
SENATORKIRK	Senator Mark Kirk 
JacksonJrOnline	Representative Jesse L. Jackson, Jr. 
repgutierrez	Representative Luis V. Gutierrez 
RepMikeQuigley	Representative Mike Quigley
PeterRoskam	Representative Peter Roskam 
DannyKDavis	Representative Danny K. Davis
RepJoeWalsh	Representative Joe Walsh
janschakowsky	Representative Janice Schakowsky 
repdold	Representative Robert J. Dold
repkinzinger	Representative Adam Kinzinger 
jerrycostello	Representative Jerry F. Costello 
JudyBiggert	Representative Judy Biggert 
rephultgren	Representative Randy Hultgren
donmanzullo	Representative Don Manzullo 
RepSchilling	Representative Bobby Schilling 
repaaronschock	Representative Aaron Schock
RepShimkus	Representative John Shimkus
senatorlugar	Senator Richard G. Lugar 
SenDanCoats	Senator Dan Coats 
repvisclosky	Representative Peter J. Visclosky 
RepDonnelly#	Representative Joe Donnelly 
toddrokita	Representative Todd Rokita 
RepDanBurton	Representative Dan Burton
RepMikePence	Representative Mike Pence
repandrecarson	Representative Andre Carson 
RepLarryBucshon	Representative Larry Bucshon
RepToddYoung	Representative Todd Young
ChuckGrassley	Senator Chuck Grassley
SenatorHarkin	Senator Tom Harkin 
BruceBraley	Representative Bruce Braley
LeonardBoswell	Representative Leonard L. Boswell 
TomLatham	Representative Tom Latham
SteveKingIA	Representative Steve King 
senpatroberts	Senator Pat Roberts 
moranforkansas	Senator Jerry Moran
conghuelskamp	<span>Representative Tim Huelskamp </span>
replynnjenkins	Representative Lynn Jenkins 
kevinyoder	Representative Kevin Yoder
repmikepompeo	Representative Mike Pompeo
SenRandPaul	Senator Rand Paul 
RepGuthrie	Representative John YarmuthRepresentative Ed WhitfieldRepresentative Brett Guthrie
RepGeoffDavis	Representative Geoff Davis
DavidVitter	Senator David Vitter
repjefflandry	Representative Jeff Landry
RepFleming	Representative John Fleming
USRepAlexander	Representative Rodney Alexander 
drcassidy	Representative Bill Cassidy 
Repboustany	Representative Charles W. Boustany, Jr. 
senatorsnowe	Senator Olympia J. Snowe
senatorcollins	Senator Susan Collins 
chelliepingree	Representative Chellie Pingree 
RepMikeMichaud	Representative Mike Michaud
senatorbarb	Senator Barbara Mikulski 
senatorcardin	Senator Benjamin L. Cardin 
WhipHoyer	Representative Steny Hoyer
JohnKerry	Senator John Kerry 
ussenscottbrown	Senator Scott Brown 
repmcgovern	Representative Jim McGovern 
nikiinthehouse	Representative Niki Tsongas
stabenow	Senator Debbie Stabenow 
SenCarlLevin	Senator Carl Levin
congressmandan	Representative Dan Benishek 
RepHuizenga	Representative Bill Huizenga 
repjustinamash	Representative Justin Amash 
RepDaveCamp	Representative Dave Camp 
RepWalberg	Representative Tim Walberg 
RepGaryPeters#	Representative Gary Peters 
CandiceMiller	Representative Candice Miller 
ThadMcCotter	Representative Thaddeus McCotter 
repsandylevin	Representative Sandy Levin
HansenClarke	Representative Hansen Clarke 
repjohnconyers	Representative John Conyers, Jr. 
john_dingell	Representative John Dingell
DaleKildee	Representative Dale E. Kildee
RepFredUpton	Representative Fred Upton
AlFranken	Senator Al Franken
repjohnkline	Representative John Kline
RepErikPaulsen	Representative Erik Paulsen 
keithellison	Representative Keith Ellison 
MicheleBachmann	Representative Michele Bachmann
chipcravaack	Representative Chip Cravaack
rogerwicker	Senator Roger Wicker
RepAlanNunnelee	Representative Alan Nunnelee
GreggHarper	Representative Gregg Harper 
congpalazzo	Representative Steven Palazzo 
clairecmc	Senator Claire McCaskill
RoyBlunt	Senator Roy Blunt 
ToddAkin	Representative Todd W. Akin 
RepCarnahan	Representative Russ Carnahan 
auctnr1	Representative Billy Long 
jontester	Senator Jon TesterRepresentative Dennis Rehberg 
SenBenNelson	Senator Ben Nelson 
Mike_Johanns	Senator Mike Johanns 
JeffFortenberry	Representative Jeff Fortenberry 
leeterryne	Representative Lee Terry 
SenatorReid	Senator Harry Reid
DeanHeller	Senator Dean Heller
Repberkley	Representative Shelley Berkley 
RepJoeHeck	Representative Joe Heck 
JeanneShaheen	Senator Jeanne Shaheen
SenatorAyotte	Senator Kelly Ayotte 
RepFrankGuinta	Representative Frank C. Guinta 
RepCharlesBass	Representative Charles F. (Charlie) Bass 
franklautenberg	Senator Frank R. Lautenberg
senatormenendez	Senator Robert Menendez 
RepLoBiondo	Representative Frank A. LoBiondo 
Runyan2010	Representative Jon Runyan 
FrankPallone	Representative Frank Pallone, Jr. 
rushholt	Representative Rush Holt
BillPascrell	Representative Albio Sires Representative Bill Pascrell, Jr.
tomudall	Senator Tom Udall 
Heinrich4NM	Representative Martin Heinrich
repstevepearce	Representative Steve Pearce 
repbenraylujan	Representative Ben Ray Lujan 
ChuckSchumer	Senator Charles E. (Chuck) Schumer
sengillibrand	Senator Kirsten Gillibrand 
RepSteveIsrael	Representative Steve Israel
reppeteking	Representative Pete King 
repmccarthyny	Representative Carolyn McCarthy 
GregoryMeeks	Representative Gregory W. Meeks
cbrangel	Representative Charles B. Rangel 
repjoseserrano	Representative Jose E. Serrano 
NitaLowey	Representative Nita M. Lowey 
RepNanHayworth	Representative Nan A. S. Hayworth 
repchrisgibson	Representative Chris Gibson 
paultonko	Representative Paul D. Tonko 
mauricehinchey	Representative Maurice D. Hinchey 
BillOwensNY	Representative Bill Owens
reprichardhanna	Representative Richard L. Hanna
RepBuerkle	Representative Ann Marie Buerkle 
louiseslaughter	Representative Louise M. Slaughter 
RepTomReed	Representative Tom Reed 
repbrianhiggins	Representative Brian Higgins
SenatorBurr	Senator Richard Burr
SenatorHagan	Senator Kay Hagan
RepReneeEllmers	Representative Renee L. Ellmers
RepWalterJones	Representative Walter B. Jones, Jr.
virginiafoxx	Representative Virginia Foxx 
RepMikeMcIntyre	Representative Mike McIntyre 
SueMyrick	Representative Sue Myrick 
PatrickMcHenry	Representative Patrick McHenry
RepBradMiller	Representative Brad Miller 
RepRickBerg	Representative Rick Berg 
sensherrodbrown	Senator Sherrod Brown 
robportman	Senator Rob Portman
repstevechabot	Representative Steve Chabot
RepMikeTurner	Representative Michael R. Turner 
Jim_Jordan	Representative Jim Jordan 
boblatta	Representative Bob Latta 
RepBillJohnson	Representative Bill Johnson 
SteveAustria	Representative Steve Austria 
SpeakerBoehner	Representative John A. Boehner 
Dennis_Kucinich	Representative Dennis J. Kucinich 
mlfudge	Representative Marcia L. Fudge 
SteveLaTourette	Representative Steven C. LaTourette
RepSteveStivers	Representative Steve Stivers
repjimrenacci	Representative James B. Renacci
repbobgibbs	Representative Tim Ryan
repbobgibbs	Representative Bob Gibbs 
jiminhofe	Senator James M. Inhofe
TomCoburn	Senator Tom Coburn 
USRepSullivan	Representative John Sullivan 
replankford	Representative James Lankford 
ronwyden	Senator Ron Wyden
SenJeffMerkley	Senator Jeff Merkley 
repgregwalden	Representive Greg Walden
repblumenauer	Representative Earl Bluemenauer
repschrader	Representative Kurt Schrader
SenBobCasey	Senator Robert P. Casey, Jr.
SenToomey	Senator Pat Toomey 
RepBrady	Representative Robert A. Brady
chakafattah	Representative Chaka Fattah 
repjasonaltmire	Representative Jason Altmire 
CongressmanGT	Representative Glenn (GT) Thompson
JimGerlach	Representative Jim Gerlach 
repmeehan	Representative Patrick Meehan 
RepFitzpatrick	Representative Mike Fitzpatrick 
RepBillShuster	Representative Bill Shuster 
RepTomMarino	Representative Tom Marino 
reploubarletta	Representative Louis J. (Lou) Barletta 
RepMarkCritz	Representative Mark S. Critz &nbsp;
USRepMikeDoyle	Representative Mike Doyle 
dentpressshop	Representative Charlie Dent
pedropierluisi	Resident Commissioner Pedro Pierluisi
SenWhitehouse	Senator Sheldon Whitehouse 
jimlangevin	Representative Jim Langevin 
GrahamBlog	Senator Lindsey Graham
jimdemint	Senator Jim DeMint 
RepTimScott	Representative Tim Scott 
CongJoeWilson	Representative Joe Wilson 
tgowdysc	Representative Trey Gowdy
RepMickMulvaney	Representative Mick Mulvaney
Clyburn	Representative James E. Clyburn 
RepJeffDuncan	Representative Jeff Duncan
SenJohnsonSD	Senator Tim Johnson 
johnthune	Senator John Thune
RepKristiNoem	Representative Kristi Noem 
SenAlexander	Senator Lamar Alexander
senbobcorker	Senator Bob Corker 
drphilroe	Representative Phil Roe
repchuck	Representative Chuck Fleischmann 
DesJarlaisTN04	Representative Scott DesJarlais 
repjimcooper	Representative Jim Cooper 
dianeblacktn06	Representative Diane Black 
dianeblacktn06	Representative Marsha Blackburn
repcohen	Representative Steve Cohen
kaybaileyhutch	Senator Kay Bailey Hutchison 
johncornyn	Senator John Cornyn
replouiegohmert	Representative Louie Gohmert
JudgeTedPoe	Representative Ted Poe 
SamsPressShop	Representative Sam Johnson 
RepHensarling	Representative Jeb Hensarling 
RepJoeBarton	Representative Joe Barton 
CongCulberson	Representative John Culberson 
RepKevinBrady	Representative Kevin Brady 
mccaulpressshop	Representative Michael McCaul 
RepKayGranger	Representative Kay Granger
repronpaul	Representative Ron Paul
RepFlores	Representative Bill Flores
JacksonLeeTX18	Representative Sheila Jackson Lee
randyneugebauer	Representative Randy Neugebauer
LamarSmithTX21	Representative Lamar Smith 
PeteOlson	Representative Pete Olson 
RepCanseco	Representative Francisco R. (Quico) Canseco 
RepKenMarchant	Representative Kenny Marchant
michaelcburgess	Representative Michael C. Burgess 
farenthold	Representative Blake Farenthold 
RepGeneGreen	Representative Gene Green 
RepEBJ	Representative Eddie Bernice Johnson 
JudgeCarter	Representative John R. Carter 
petesessions	Representative Pete Sessions 
OrrinHatch	Senator Orrin G. Hatch
SenMikeLee	Senator Mike Lee 
repjimmatheson	Representative Jim Matheson 
jasoninthehouse	Representative Jason Chaffetz 
SenatorLeahy	Senator Patrick Leahy
senatorsanders	Senator Bernie Sanders 
markwarner	Senator Mark R. Warner 
robwittman	Representative Rob Wittman
RepScottRigell	Representative Scott Rigell
RepBobbyScott	Representative Bobby Scott 
Randy_Forbes	Representative Randy Forbes
reproberthurt	Representative Robert Hurt 
repgoodlatte	Representative Bob Goodlatte
EricCantor	Representative Eric Cantor
jim_moran	Representative Jim Moran
RepMGriffith	Representative Morgan Griffith 
GerryConnolly	<span>Representative Gerry Connolly</span>
DelegateDonna	Delegate Donna M. Christensen
RepInsleeNews	Representative Jay Inslee 
herrerabeutler	Representative Jaime Herrera Beutler 
cathymcmorris	Representative Cathy McMorris Rodgers
RepNormDicks	Representative Norm Dicks 
repjimmcdermott	Representative Jim McDermott 
davereichert	Representative Dave Reichert 
rep_adam_smith	Representative Adam Smith 
senrockefeller	Senator Jay Rockefeller 
Sen_JoeManchin	Senator Joe Manchin 
RepMcKinley	Representative David McKinley 
SenRonJohnson	Senator Ron Johnson 
reppaulryan	Representative Paul Ryan 
reptammybaldwin	Representative Tammy Baldwin 
RepGwenMoore	Representative Gwen Moore 
RepSeanDuffy	Representative Sean Duffy 
repronkind	Representative Ron Kind
repribble	Representative Reid Ribble
senjohnbarrasso	Senator John Barrasso 
cynthialummis	Representative Cynthia Lummis
